11111111111111111
10000000000000001
10102210001220101
10225220302252201
10241400300515201
10444442225555501
10141412321515101
12332333333323321
10224440305555201
10122420302522101
10002242225220001
10101222322210101
10000022322000001
10101000000010101
11111111111111111